 3  1  5  0  6  2  4  7  1  3  0  5  6  2  4  7  1  3  0  6
 2  4  1  7  3  5  0  6  2  4  1  7  3  5  0  6  2  4  1  5
 0  6  2  4  1  3  5  7  0  6  2  4  1  3  5  7  0  6  2  4
 5  7  0  6  2  4  1  3  5  7  0  6  2  4  1  3  5  7  0  6
 1  3  5  7  0  6  2  4  1  3  5  7  0  6  2  4  1  3  5  7
 6  2  4  1  3  5  7  0  6  2  4  1  3  5  7  0  6  2  4  1
 4  1  3  5  7  0  6  2  4  1  3  5  7  0  6  2  4  1  3  5
 7  0  6  2  4  1  3  5  7  0  6  2  4  1  3  5  7  0  6  2
 3  5  7  0  6  2  4  1  3  5  7  0  6  2  4  1  3  5  7  0
 2  4  1  3  5  7  0  6  2  4  1  3  5  7  0  6  2  4  1  3
 0  6  2  4  1  3  5  7  0  6  2  4  1  3  5  7  0  6  2  4
 5  7  0  6  2  4  1  3  5  7  0  6  2  4  1  3  5  7  0  6
 1  3  5  7  0  6  2  4  1  3  5  7  0  6  2  4  1  3  5  7
 6  2  4  1  3  5  7  0  6  2  4  1  3  5  7  0  6  2  4  1
 4  1  3  5  7  0  6  2  4  1  3  5  7  0  6  2  4  1  3  5
 7  0  6  2  4  1  3  5  7  0  6  2  4  1  3  5  7  0  6  2
 3  5  7  0  6  2  4  1  3  5  7  0  6  2  4  1  3  5  7  0
 2  4  1  3  5  7  0  6  2  4  1  3  5  7  0  6  2  4  1  3
 0  6  2  4  1  3  5  7  0  6  2  4  1  3  5  7  0  6  2  4
